D...........................................................................XXXXXXXXXXXX............................................................................
...................................................................XXXXXXXXXXXXXXXXXXXXXXXXXXXXX....................................................................
..............................................................XXXXXXXXXXXXXXXXXXXXXXXXXXXXXXXXXXXXXXX...............................................................
..........................................................XXXXXXXXXXXXXXX111XX1XX1XXXXXX1XXXXXXXXXXXXXXXX...........................................................
.......................................................XXXXXXXXXXXX1XXXX111111111111XXX11111111XXXXXXXXXXXXX........................................................
....................................................XXXXXXXXXXXX1111111111111111111111111111111XXXXXXXXXXXXXXXX.....................................................
..................................................XXXXXXXXXX1X11XX111111111111111111111111111111XXXXXXXXXXXXXXXXXX..................................................
...............................................XXXXXXXX1X1111111111111111111111111111111111111111111XXXXXXXXXXXXXXXX................................................
.............................................XXXXXXX1111111111111111111111111111111111111111111111111111XXXXXXXXXXXXXX..............................................
...........................................XXXXXXX111111111111111111111111111111X1111111111111111111111111XXXXX1XXXXXXXX............................................
.........................................XXXXXX1111111111111111111111X11111111111111111111111111111111111111X11111XXXXXXXX..........................................
.......................................XXXXXXX111111111111111111111111111111111111111111111111111111X11X111111111111XXXXXXXX........................................
......................................XXXXXX1111X111111111111111111111111111111111111111111111111111111111111111111111XXXXXXX.......................................
....................................XXXXXX11111111111111111111111111111111X11111111111111111111111111111111111111111111XXXXXXXX.....................................
...................................XXXXXX1111111111111111111111111111111111111111111111111111111111111111111111111111X1XXXXXXXXXX...................................
.................................XXXXXX111111111111111111111X1111111X11111111111111111111111111111111111111111111X11111111X1XXXXXX..................................
................................XXXXX111X111111111111111111111111X111111111111111111111111111111111111111111111111111111X1111XXXXXX.................................
...............................XXXX1X11111X1111111111111111111X1111111111111111111XX11111XX111111X1111X1111111111111111111X111XXXXXXX...............................
.............................XXXXX11111111X1111111111111111111X1111111111111111111X1111111111111111111X1111111111111X11111X111XXXXXXXX..............................
............................XXXXX111111111X111X111111111111111X1111111111111111111X1111111111111111111X1111111111111111111X11X1111XXXXX.............................
...........................XXXX111X1111X11X1111111111111111111X1111111111111111111X1111111111111111111XX111111111111111111X1111111XXXXXX............................
..........................XXXX111111111111XX111111111111X11111X1111111111111111111X1111111111111111111X111111X111111111111X11111111XXXXXXX..........................
.........................XXXX1111111111111X1111111111111111111X1111111111111111111X111111111X111111111X111X111111111111111X11111111111XXXXX.........................
........................XXXX11X11111111111X1111111111111111111X1111111111111111111XX1111111111X1111111X111111111111111X111X1111111X111XXXXXX........................
.......................XXXX111111111111111X1X11111111111111111X1111111111111111111X1111111111111111111X1111111111111111111X111111111111XXXXXX.......................
......................XXXX111111111111111XX111111111X11111111XX111111111111111111XX111111111111111111XX111111111111111111XX111111111111XXXXXXX......................
.....................XXXX11111111X1111111XX1111111111111111X1XX111111111111111111XX111111111111111111XX111111111111111111XX1111111111111XXXXXXX.....................
....................XXXX11111111X111111111111111111111111X1111111111111111111X11111111111111111111111111111111111111111111111111111111111XXXXXXX....................
...................XXXX11111111111111111111111111111X11111111111X1111111111111111X1111111111111111111111111111111111111111111111111111111XXXXXXX....................
..................XXXX111111111111111111111111111111111111111111111111111111111111X1111111111111111111111111111111111111111111111111111111XXXXXXX...................
.................XXXX1111X1111111111111111111111111111111111X111111111111111111111111111111111111111X111111111X11111111111111111111111111111XXXXXX..................
................XXXX1111111111111X1X1111111111111111111111111111111111X1111111111111111111111111111111X111111111X11111111111X11111111111111XXXXXXXX.................
................XXX111111111111111X1111111111111111111111111111111111111111111111111X1111111111111111111111111111111111111111X111111111111XXXXXXXXXX................
...............XXX11111111111111111111X11111111111111111111111111111111111111111111111111111111111111111111111111111111111X1111111X1111111XXXXXXXXXXX...............
..............XXXX1111111111111111111111111111111111111111111111111111111111111111111111111111111111111111111111111111111111111111111111111XXXXXXXXXX...............
.............XXXX1111111111111111111X111111111111111111111111111111111111111X111111111111111111111111111111111111111111111111111111111111X11XXXXXXXXXX..............
.............XXX111111111111111111111111111111111111111111111111111111111X111111111111111X11111111111111111111111111111111111111111111111111XXXXXXXXXXX.............
............XXX1111111111111111X1111111111111111111111111111111111111111111111111111111111111111111111111111111111111111111111111111111111X11XXXXXXXXXX.............
...........XXXX1111111XX111111111111111111111111111111X111111111111111X1111111111111111111111111111X111111111111111111X1111111111X111X111X111XXXXXXXXXXX............
...........XXXX11111111111111111X1111111111111111111111111111X111111111111111X1111111111111111111111111111111111111111111111111111111111111111XXXXXXXXXXX...........
..........XXXX11111111111111111111111111111111111111111111111111111X11X1111111111111111X1111111111111111111111111111111111111111111111111111111XXXXXXXXXX...........
..........XXX1111111111111111111111111111111111111111111111111111111111111111111111111111111111111111111111111111111111111111111111111111111111111111XXXXX..........
.........XXXX1111111X1X11X1111111111111111X1111111111111111111XX111111111111111111XX11111111111111111XX1111X11111111111111X1111111111111111111X1111111XXXX..........
.........XXX1111111111X111111111X11111X111X1111111111111111111X111X1X1111111111111X1111111111X1111111XX1111111111111111111X1111111111111111111X11111111XXXX.........
........XXXX1111111111X11111111X1111111111X1111111111111111111X111111111111111111XX111111111111111X111X1111111111111111111X1111111111111111111XX1111111XXXX.........
.......XXXX11111111111X1111111111111111111X1111111111111111111X1111111111111111111X1111111111111111111X11111X1111111111111X1111111111111111111X11111111XXXXX........
.......XXX1111111X11X1X11111111X1111111111X1111111111111111111X1111111111111111111X1111111111111111111X1111111111111111111X1X11111111111111111X11111111XXXXX........
.......XXX111111111111X1111111111111111111X1111111111111111111X1111111111111111111X1111111111111111111X1111111111111111111X1111111111111111111X1111111111XXXX.......
......XXX1111111111111X1111111111111111111X1111111111111111111X1111111111111111111X1111111111111111111XX111111111111111111XX1111111X1111111111XX1111111111XXX.......
......XXX1111111111111X1111111111111111111X11111111111X1111111X111111XX11111111111X1111111111111111111X1111111111111111111X111111111X111111111X11111111111XXXX......
.....XXX1111111111111XX111111111111111111XX111111111111111111XX1X111X11111X111111XX111111111111111111XX11111X1111111X1111XX111111111111111111XX11111111111XXXX......
.....XXX1111111111111XX111111111111111111XX111111111111111111XX111111111111111111XX11111X111111111111XX11111111111111X111XX111111111111111111XX111111111111XXX......
....XXX1111111111111111111X1111111111111111111111111111111111111111111X111111111111111111111X1111111111111111111111111111111111111111X111111111111111111111XXXX.....
....XXXX1111111111111111111111111111111111111111111111111111X11111111111111111111111111111111111111111111111111111111111111111111111111111111111111111111111XXX.....
....XXX111XX11111111111111111111111111111111111X1111111X11111XX1X1X1111111111111111111111111111111111111111111111111111111X111X111111111111111111111111111XXXXXX....
...XXX111111111111111111111111111111111X11111111111111111111111111111111111111111111111111111111X111111111111111111111111111X1111111111111111111111111111111XXXX....
...XXX111111111111111111111111111111111111111111111X111111111111111111X11111111111111111111111111111X11111111111111111111111111111111111111111111111111111111XXX....
...XXX1111111111111111111111111111111111111111111111111111111111111111111111111111111111111111111111111111X11111X111111111111111111X111111111111111111111111XXXX....
...XXX1111111111111111111111111111111111111111111111111111111111111111111111111111111111111111111111111111111111111111111111111111111111111111111111X11111111XXXX...
..XXXX1111111111111111111111111111111111111111111111111111111111X111111111111111111111111111111111111111111111111111111111111111111111111111111111111111111111XXX...
..XXXX1111111111111111111111111111111111111111111111111111111111111111X1111111111111111111111111111111111111111111111111X11111111111111X11X111111X11111111111XXXX...
..XXX111111111111X1111111X11111111111111111111111111111111111111111111111111111111111111X1111111111111111111111X1111111111111111111111111111111111111111111111XXXX..
..XXXX111111111111111111111111111111111111111111111111111111X1111X1111111111X111111111111111XX11111111111111111111111111X11111111111111111111111111111111111111XXX..
.XXXX111111111111111111111111111111111111111111111111111111111111111111111X11111111111111111111111111X111111111111111111111111111111111111111111111111111111X1XXXX..
.XXX111111111111111111111X1111111111111111X111111111111111111111111111111111111111111111111111111111111X1111111X1111111XX111111111111111111X111111111111111111XXXX..
.XXXX1111111111111X1111111X1111111111111X11111111111X1111111111111111111111111111111111X11111111111111111111111111111111111111111111111111X111111111111111X1111XXX..
.XXXX111111111111111111111111111X11111111111111111111111111111111X11X111111111111111111111111111111111X11111111111111111111111111111111111111111111111111111111XXXX.
.XX11111111X11111111X1X1111111111111111111X1111111111111111111X1111111111111111111X1111111111111111111X1111111111111111111X1111111111111111111X11111111111111111XXX.
XXX1X111111111X1111111X1111111111111111111X1111111111111111111X1111111111111111111X1X111111111111111X1XX111111111111111111X1111111111111111111X11111111111111111XXX.
XXX1111111111111111111X1111111111111111111X1111X11111111111111XX111111111111111111X111111111111X11X111X111111111X111111111X1111111111111111111XX1111111111111111XXX.
XXX1111111X11111111111X111111111111111X111X111X1111X1111111111X111111111111X11X111X1111111X111X111X111X1111111X11111111111X1111111X11111111111X11111111111111111XXX.
XXX11X1111111111111111X1111111111111111111XX111111111111111111XX11111111111111X111X1111111111111111111X1111111111111111111X11111111111X111111XX11111111111111111XXX.
XXX1111111111X1X111111X1111111111111111111X111111111111111X111X111111111111111111XXX111111111111111111X1111111111111111111X1111111111111111111X11111111111111111XXX.
XXX11111111X1111111111X1X11111X11111111111X11111111111111X1111X11X111111111111111XX1111111111111111111X1111111111111X1X111X1111X11111111111111X11111111111111111XXX.
XXX1111111111111111111X1X11111111111111111X111111X111111111111X1111111111111111111XX111111111111111111X1111111111111111111X1111111111111111111X11111111111111111XXX.
XXX111111111X1111X111XX111111111111111111XX111111111111111111XX111111111X11111111XX1111111111X1111111XX111111111111111111XX11111111111X111111XX111111111111111111XXX
XXX11111X1111111111X1XX111111111111111111XX111111111111111111XX111111111111111111XX111111111111111111XX111111111111111111XX111111111111111111XX111111111111111111XXX
XXX1111111111111111111111111111111111X111111111111111111111111111111X11111111111111111111111111111111111111111111111111111111111111111111111111111X11111111111111XXX
XXX111111111111X1111111111111111111111111111111111111111111111111111111X111111111111111111111111111111111111111111111111111111X1111111111111111111111111111111111XXX
XXX11111111111111111111111111111111111111111111111X11111111111111111111111111111X111111111111111111111111111111111111111111111111X1111111111111111111111111111111XXX
XXX1111111111111111111111111111111111111X11111111111111111111111111111111111111111111111111111111111111111111111111111111111111111111111111111111111111111111111XXXX
XXX111111X11111111X11111X1111111111111111111111111111111111111111111111111111111111111111111111111111111111111111111111111111111111111111111111X11111111111111111XXX
XXX11111111111111111111111X11111111111111111111111111111111111111111111111111111111X111111111111111111111111111111111111111111111111111111111X11111111111111X1111XXX
XXX11111111111111111X11111111111111111111111111111111111111111111111111111111111111111111111111111111111111111111111111111111111111111111111111111111111111111111XX.
XXX1X11111111111111111111111111111111111111111111111111111111111111111111111111111111111111111111111111111111111111111111111111111111111111X111111111111111111111XX.
XXX111111111111111111111111111111111111111111X11111111111111111111111111111111X1111111111111X11111111111111111111111111111111111111111111111X11111111111111111111XX.
XXX11X1111111X11111111X1111111X111111X1X111111X1X1111111111111111111111111X11111111111X1X1111111111111X111111111111111111111111111X111X1111111X11111111111111111XXX.
XXX11111111111111111111X1111111111111111111111111111111111111111111111111111111111111111111111111111X11111111111111111111111111111111111111111111111111111111111XXX.
XXX11111111111111111111111111X111111111111111111111111111111111111111111111111111111111111111111111111111111111111111X111111X1111111111111111111111111111111X111XXX.
XXX1111111111111111111111111111111111111111111111111111111111111111111111111111111111111111111111111111111111111111111111111111111111111111111111111111111111111XXX.
.XX11111111111111111111111111111111111111111111111111111111111111111111111111111111111111111X11111111111111111111111111111111111111111111X1111111111111111111111XXX.
.XXX111111111111X11111111X1111111111111111111111111111111111111111111111111111X111111111111111111111111111111111111111111111111111111111111111111111111111111111XXX.
.XXX111111111111111111XX1111111111X1111111X1111111111111111111X1111111111111111111X1111111111111111111X1111111111111111111X1111111111111111111X11111111111111111XX..
.XXX111111111111X11111X1111111111111111111X1111111111111111111X111111111X111111111X1111111111111111111X11111111111X1X11111X1111111111111111111X1111111111111111XXX..
.XXX111111111111111111X1111111111111111111X111X111111111111111X11111111111111X1111X1111111111111111111X1111111111111111111X1111111111111111111X111111111111111XXXX..
.XXX1111X1111111111111X11111111111X1111111X1111111111111111111X1111111111111111111X1111111X11111111111X1X111XX111111111X11X1111111111X1111X111X1111111111111111XXX..
..XXX11111111111111111X1111111111111111111X1111111111111111111X1111111111111111111X1111111111111111111X1111111111111111111X1111111111111111X1XX1111111111111111XXX..
..XXX1111111111111X111X1111111111X11111111X1X11111111111111111X111X111111111111111X111111111111111X111X1111111111111111111X1111111X11111111111X111111111111111XXX...
..XXX1111X111111111111X1111111111111111111X11111X1111111111111X1111111111111111111X1111111111111111111X1111111111111111111X1111111111111111111X111111111111111XXX...
..XXX11111111111111111X1111111X11111111111X11111111X1111111111X1111111111111111111X111111111X111111111X1111111111111111111X11111X1111111111111X1X1111111111111XXX...
...XXX111X11111111111XX111111111111111111XX1111X1111111111111XX111111111111111111XX111111111111111111XX11111X111111111111XX111111111111111111XXX1111111111111XXXX...
...XXX111111111111111XX111111111111111111XX111111111111111111XX111111111111111111XX111111111111111111XX111111111111111111XX111111111111111111XX1111X11111111XXXX....
...XXX11XXX111111111111111111111111X1111111111111111111111111111111111X1111X111111X111111X1111111111111111111111111111X1X111111111X11111111111111X1X111111X1XXXX....
....XXX111111X1111111111111111111111111111111111111111111111111111111111111X11111111111111111111111111111111111111111111111111111111111111111111111111111X111XXX....
....XXX111111X111111111111111X1111111111111111111111111111111111111111111111111111111111111111111111111111111111111111111X1111111111111111111111111111111111XXX.....
....XXX11111111111X1111111111111X11111111111111111111111111111111111111111111111111111111111111111111111111111X1111111111111111111111111111111X111111111111XXXX.....
.....XXX1111111111111X1111111111111111111111111111111111111111111111111111111111111111X1111111111111111111111111111111111111111111111111111111111111111111XXXX......
.....XXX1111111111111111111X1X1111111111111111111111111111111111111111111111111111111111111111111111X11111111111111111111111111111111111X11111111111111111XXXX......
......XXX111111111111111111111111111111111111111111111111111111111111111111111111111111111111111111111111111111111111111111111111111111111111X111111111111XXXX......
......XXX1111111111111111111X1111111111111111X1111111111111111111111111111111111111111111111111111111111111111111111111111111111111111111111111111X1111111XXX.......
......XXXX11111X111111111111111111111111111111111111111X111111111111111111111111111111111111111111111111X111111111111111111111111111111111111111111111111XXXX.......
.......XXX11X111XX1111111111111111111111111111X1111XX11111111111111111111111111111111111111111111111111111111111111111X1111111111111111111111111111111X11XXX........
.......XXXX11111X111111111111111X11111111111111111111111111111111111111111111111X111111111111111111111X11111111111111111111111111111111111111111111X1111XXXX........
........XXX11111111111111111111111111111111111111111111111111111111111111X111111111111111111111111111111111111111111111X1111111111111111111X111111111111XXX.........
........XXXX111111111111111111111111111111111111111111X111111111X1111111111111111111111111111111111111111111111111111111111111111111111111111111111111XXXXX.........
.........XXXX1111111111111111X1111111111111111111111111111111111111111111111111111111111X1111111111111111111111111111111111111111111111111111111111111XXXX..........
..........XXXX111111XX111111111111X1111111111111111111111111111111111111111111111111111111111111111111111111111111111111111111111111111111111111X11111XXXX..........
..........XXXXXXXXXXXXX111111111111111X111X1111X11111111111111X11111111111X1111111X11111111111111X1111X1111111111111111111X1111111111111111111X11111XXXXX...........
...........XXXXXXXXXXXX111111111111111X111X11X1X11111111111111X1111111X11111111111X11X1111111111111111X1111111111111111111X1111111111111111111X11X111XXXX...........
...........XXXXXXXXXXXX1111111111111111111X1111111111111111111X11111111X1111111111X1XX1111111111111111X1111X11111111111111X1111111111111111111X1111XXXXX............
............XXXXXXXXXXX11111X1111111111111X1111111111111111111XX111111111111111111X111X111111111111111X1X11111111111111111X111X111111111111111X1111XXXX.............
.............XXXXXXXXXX1111111111111111111X1111111111111111111X1111111111111X11111X1111X11111111111111X1111111111111111111X1111111111111111111X111XXXXX.............
.............XXXXXXXXXX1111111111111111X1XX1111111111111111111X1111111111111111111X1111111111111111111X1111111111111111111X1111111111111111111X111XXXX..............
..............XXXXXXXXX11111X1111111111111X1111111111111111111X1111111111111111111X11111X1111111111111X1111111111111111111X1111111111111111111X111XXX...............
...............XXXXXXXXX111111111111111111X1111111111111111111X1X11111111111111111X1111111111111111111X1111111111111111111X1111111111111111111X1XXXXX...............
...............XXXXXXXXX11111111111111111XX111111111111111111XX11111111111X111111XX111111111111111111XX111111X11111111111XX1X1111X11111111111XXXXXXX................
................XXXXXXXX11111111111111111XX111111111111111111XX111111111X11111111XX111111111111111111XX111111111111111111XX111111111111111111XXXXXX.................
.................XXXXXXXX111X11111111111111111111111X11111111111111111X11111111111111111111111111111111111111111111111111111111111111111111111XXXX..................
..................XXXXXX1111111111111X1111111X111111111111111111X11111111111111111111111111X11111111111111111111111111111111111111X1111111111XXXX...................
...................XXXXX1111111111111111111111111111111111111111111111111111111111111111X11111X111111111111111111X11111111XX111111111111111XXXXXX...................
....................XXX111111111111111111111111111111111111111111111111111111111111111111111111111111111111111111X11111111111X1111111111X111XXXX....................
....................XXXX1111111111X111111111111111111111X111111111111111111111111111111111X1111111111111111111111111111111111111111111111XXXXXX.....................
.....................XXXX11111111111111111111111111111111X111111111111111111111111111111111111111111111111111111X1111111111111111111111111XXXX......................
......................XXXX111111111X11111111111111111111111111111111111111111111111111111111111X11111X111111111111111111111X1111111111111XXXX.......................
.......................XXXXX1111X1111111X1111111X1111111X1111111XX11X111X1111111X111X111X1111111X1111111X1111111X11111111111X1111111111XXXXX........................
........................XXXXX1111111111111111111111111111111111111111111111111111111111111111111X111111111111111111111111X111111111111XXXXX.........................
..........................XXXX111111111111111111111111X11111111111X1111111111111111111111111111111111111111111111111X1111111111111111XXXXX..........................
...........................XXXX1111111111111111111111111111111111111111111111111111111XX11111111111111111111111111111111111111111111XXXXX...........................
............................XXXX11111111111111111111111111111111111111X11111111111111111111111111X111111111111111111111111111111111XXXX.............................
.............................XXXXX111111X1111111111111111111111111111111111111111111111111111111111111111111111111111111111111111XXXXX..............................
..............................XXXXX11111111111111111111111111111111111111111111X11111111111111111111X11X1111111111111X1111111111XXXXX...............................
................................XXXXX1111111111111111111111X1111111111111111111111111111111111111111111111111111111111111111111XXXXX................................
.................................XXXXX1111X1111111111111111111X1111111111111111111X1111111111111111111X1111111111111111111X11XXXXX..................................
..................................XXXXXX11X1111111111111111111X1111111111111111111X1111111111111111111X1111111111111111111XXXXXXX...................................
....................................XXXXX1X1111111111111111111X1111111111111111111X1111111111111111111X1111111111111111111XXXXX.....................................
......................................XXXXX1111111111111111111X1111111111111111111X1111111111111111111X11111111111111111XXXXXX......................................
.......................................XXXXXXX1111111111111111X1111111111111111111X1111111111111111111X111111111111111XXXXXX........................................
.........................................XXXXXX111111111111111X1111111111111111111X1111111111111111111X111111111111XXXXXXX..........................................
...........................................XXXXXXX111111X11111X1111111111111X11111X1111111111111111111X1111111111XXXXXXX............................................
.............................................XXXXXXX111111111XX111111111X111111111X1111111111111111111X11111111XXXXXXX..............................................
...............................................XXXXXXXXXXXXXXXXXXXXXXXXXXXXXXXXXXXXXXXXXXXXXXXXXXXXXXXXXXXXXXXXXXXXX................................................
.................................................XXXXXXXXXXXXXXXXXXXXXXXXXXXXXXXXXXXXXXXXXXXXXXXXXXXXXXXXXXXXXXXXX..................................................
....................................................XXXXXXXXXXXXXXXXXXXXXXXXXXXXXXXXXXXXXXXXXXXXXXXXXXXXXXXXXXX.....................................................
.......................................................XXXXXXXXXXXXXXXXXXXXXXXXXXXXXXXXXXXXXXXXXXXXXXXXXXXXXX.......................................................
..........................................................XXXXXXXXXXXXXXXXXXXXXXXXXXXXXXXXXXXXXXXXXXXXXXX...........................................................
..............................................................XXXXXXXXXXXXXXXXXXXXXXXXXXXXXXXXXXXXXXXX..............................................................
..................................................................XXXXXXXXXXXXXXXXXXXXXXXXXXXXXXX...................................................................
..........................................................................XXXXXXXXXXXXXXX...........................................................................
